1111111111111
1P00001E10101
1110C00100001
1X00010000001
1000010000001
1C0000000C001
1000010000001
1100X00000001
10100X0000001
1111111111111
