1111111111111
1P00000000001
11X0C00000001
1X00010000001
1000010000001
1C0000000C001
1000010000001
1000X00000001
100XEX0000001
1111111111111
