1111111111111
1000000000001
1P00C000X0001
10000100X0001
10000100X0001
1C000000XC001
10000100X0001
1000E000X0001
10000000X0001
1111111111111
