11111111
10000001
1P00C001
1000EX01
11111111